24K Magic	Bruno Mars	24K Magic	Song Folder\24K Magic audio.wav
Another One Bites the Dust	Queen	The Game	Song Folder\Another one Bites the Dust audio.wav
Beat It	Michael Jackson	Thriller	Song Folder\Beat It.wav
Believer	Imagine Dragons	Evolve	Song Folder\Believer audio.wav
Better	Khalid	Suncity	Song Folder\Better audio.wav
Billie Jean	Michael Jackson	Thriller	Song Folder\Billie Jean.wav
Bohemian Rhapsody	Queen	A Night at the Opera	Song Folder\Bohemian Rhapsody audio.wav
Castle on the Hill	Ed Sheeran	Divide	Song Folder\Castle on the Hill audio.wav
Demons	Imagine Dragons	Evolve	Song Folder\Demons audio.wav
Dirty Diana	Michael Jackson	Bad	Song Folder\Dirty Diana.wav
Girls Like You	Maroon 5	Red Pill Blues	Song Folder\Girls Like You.wav
Grenade	Bruno Mars	Doo-Wops & Hooligans	Song Folder\Grenade audio.wav
Hello	Adele	"25"	Song Folder\Hello.wav
Hey Jude	The Beatles	Hey Jude (Single)	Song Folder\HeyJudeAudio.wav
I Want to Hold Your Hand	The Beatles	Meet the Beatles!	Song Folder\IWantToHoldYourHandAudio.wav
I'm Not the Only One	Sam Smith	In the Lonely Hour	Song Folder\I'm Not The Only One.wav
Just the Way You Are	Bruno Mars	Doo-Wops & Hooligans	Song Folder\Just the Way You Are audio.wav
Location	Khalid	American Teen	Song Folder\Location audio.wav
Love Lies	Khalid	Love, Simon(Original Motion Picture Soundtrack)	Song Folder\Love Lies audio.wav
Maps	Maroon 5	V	Song Folder\Maroon 5 - Maps (Audio).wav
On Top of the World	Imagine Dragons	Night Visions	Song Folder\On Top of the World audio.wav
One More Night	Maroon 5	Overexposed	Song Folder\One More Night.wav
Payphone (E)	Maroon 5	Overexposed	Song Folder\Payphone.wav
Perfect	Ed Sheeran	Divide	Song Folder\Perfect audio.wav
Photograph	Ed Sheeran	x	Song Folder\Photograph-Ed Sheeran (Audio).wav
Radioactive	Imagine Dragons	Night Visions	Song Folder\Radioactive audio.wav
Rolling in the Deep	Adele	"21"	Song Folder\Rolling in the Deep.wav
Rumour Has It	Adele	"21"	Song Folder\RumourHasIt.wav
Saturday Nights	Khalid	Suncity	Song Folder\Saturday Nights audio.wav
Set Fire to the Rain	Adele	"21"	Song Folder\Set Fire to the Rain.wav
Shape of You	Ed Sheeran	Divide	Song Folder\Shape of You audio.wav
She Loves You	The Beatles	Twist and Shout	Song Folder\SheLovesYou.wav
Smooth Criminal	Michael Jackson	Bad	Song Folder\Smooth Criminal (2012 Remaster).wav
Someone Like You	Adele	"21"	Song Folder\SomeoneLikeYou.wav
Stay With Me	Sam Smith	In the Lonely Hour	Song Folder\Stay With Me.wav
Sugar	Maroon 5	V	Song Folder\Sugar.wav
That's What I Like	Bruno Mars	24K Magic	Song Folder\Thats What I Like audio.wav
Thinking Out Loud	Ed Sheeran	x	Song Folder\Thinking Out Loud audio.wav
Thriller	Michael Jackson	Thriller	Song Folder\Thriller.wav
Thunder	Imagine Dragons	Night Visions	Song Folder\Thunder audio.wav
Too Good at Goodbyes	Sam Smith	The Thrill of It All	Song Folder\TooGoodAtGoodByes.wav
Under Pressure	Queen	Hot Space	Song Folder\Under Pressure audio.wav
Uptown Funk	Bruno Mars	Uptown Funk	Song Folder\Uptown Funk audio.wav
We Are the Champions	Queen	News of the World	Song Folder\We are the Champions audio.wav
We Will Rock You	Queen	News of the World	Song Folder\We Will Rock You audio.wav
Yellow Submarine	The Beatles	Revolver	Song Folder\YellowSubmarine.wav
Yesterday	The Beatles	Help!	Song Folder\Yesterday.wav
Young Dumb & Broke	Khalid	American Teen	Song Folder\Young Dumb and Broke audio.wav